11111111111111111111111111111
10000000000000000000000000001
10000000000000000000000000001
10000001000000000000000000001
10000000000000001000000000001
10110000000000000100000000001
10000000000000000000000000001
10000000000000000000000000001
100P0000000000000000000000001
10000000000000000000000000001
11111111111111111111111111111