11111111111111111111111111111
100C0000000000000000000000001
1000000000000000C000000000001
10000001000000000000000000001
1000000000000000100000C000001
10110000000000000100000000001
10000000000000000000000000001
10000000000000000000000000001
100P0000000011100000000010001
1000000000000000000000001E111
11111111111111111111111111111