111111111
1000000V1
1ECP00001
111111111