11111111111111111111111111111
10000000000V00000010000000001
100000000000000V0000010000001
100000C1000000000000000000001
10000000000000001000000000001
101100000000C0000100000000001
10000000000000000000000111111
1001000000C000000V000001000E1
100P00000000C01000000C0101111
10000000000000000000000000001
11111111111111111111111111111