11111111111111111111111111111
10000000000V00000000000000001
10000C000000000000000000V0001
10000001000000000000000000001
10000000000000001000000000001
10110000000000000100000000001
10000000000000000000000111111
100000000100000000000V01000E1
100P00000000C01000000C0101111
10000000000000000000000000001
11111111111111111111111111111